11111111111111111111
18221122222222211111
12211121111112211111
12111221111122111111
12222211222722222221
11111111111111112111
11111111722222122111
11111111111132221111
11111111111112111111
11111111111114111111
;