11111111111111111111
18111111111112222111
12211111111112712111
12222211111122112111
11111211122221112111
11222222222111112211
11221111111111111211
12211111111111112211
13111111172222222111
14111111111111141111
;